NO ./img/diam.xpm
SO ./img/cobble.xpm
WE ./img/frame1.xpm
EA ./img/wood.xpm



D ./img/door.xpm ./img/opendoor.xpm



F ./img/dirt.xpm
C ./img/skyframe1.xpm ./img/skyframe2.xpm ./img/skyframe3.xpm ./img/skyframe4.xpm ./img/skyframe5.xpm

        1111111111111111111111111
        1000000000110000000000001
        1011000001110000000000001
        1001000000000000000000001
111111111011000001110000000000001
1000000000110000011101D1111111011
11110111111111011100000010001
11110111111111011101010010001
11000000110101011100000010001
10000000000000001100000010W01
10000000000000001101010010001
1100000111010101111101111000111
11110111 1110101 101111010001
11111111 1111111 111111111111
