fgsdhfjkdshfsdk

C

WE

NO

SO

EA







F


111111
110011
111111
