fgsdhfjkdshfsdk

C 1,1,1

WE ./img/cobble.xpm

NO ./img/cobble.xpm


SO ./img/cobble.xpm


EA ./img/cobble.xpm








F 1,100,1



1111111111111111111111
110W000000000000000000
1111111111111111111111
